






NO img/w/44.xpm

SO img/w/44.xpm

WE img/w/44.xpm

EA img/w/44.xpm

TF img/w/89.xpm

TC img/w/95.xpm

F 98,105,109
C 80,130,200


        1111111111111111111111111         
        1000000000110000000000001      
        1011000001110000000000001      
        1001000000000000000000001
111111111011000001110000000000001
100000000011000001110111111111111
11110111111111011100000010001
11110111111111011101010000001
11000000110101011110000010001
1000000000000000110N00001000111
10000000000000001101010010001
1100000111010101111101111001
11111111 1011111111111111111
          1